R 480 480

SO ./xpm/1.xpm
NO ./xpm/3.xpm
WE ./xpm/2.xpm
EA ./xpm/4.xpm

S ./xpm/barrel.xpm
F 123, 105,                   105                        
C 255, 165,0

        1111111111111111111111111
        1000000000110000000000001
        1011000001110000002000001
        1001000000000000000000001
111111111011000001110000000000001
100000000011000001110111111111111
11110111111111011100000010001          1111111
11110111111111011101010010001          1000001
11000000110101011100000010001          1111111
100001W0000000001100000010001
10000000000000001101010010001
1100000111010101111101111000111
11110111 1110101 101111010001
11111111 1111111 111111111111
